b________T________d
|        |        |
| -= -_= U -_= -= |
|                 |
| -= u -_T_= u -= |
|    |   |   |    |
q__d K_= U -_k b__p
MMM| |       | |MMM
___p U b=L-d U q___
       |   |       
___d u q___p u b___
MMM| |       | |MMM
b__p K_= u -_k q__d
|    |   |   |    |
| -= U -_t_= U -= |
|                 |
| -= -_= u -_= -= |
|        |        |
q________t________p
